............................
.000900....007650...........
.LL.........................
.LL.......X.X...............
............................
............................
.............P..............
.............000000.........
............................
B..K......H.H ....H.........
4444444444444444444433221100
............................
.......................H....
.............h......00112233
....0011223344556677........
..77........................
....H.......................
221100...H...........h......
......7766554433221100......
......................7766..
............................
........h.....H.........0011
........0011223344556677....
..556677....................
............................
00..H.......H...............
..7766554433221100..........
..................77665544..
............................
.F.J.....h.............H....
0000000000000011223344556677
............................
