 H    H         H     H 
 H    H         H  M  H 
EHQwWeHqWwWwWwWeHqWwWeHq
 H    H         H     H 
 H    H   H     H     H 
 H    H   H     H     H 
EHQwWwWwWeHqWwWwWwWwWeHq
 H        H           H 
 H        H           H 
 H  M     H           H 
EHQwWwWwWeHqWwWwWwWwWeHq
 H        H           H 
 H        H     H     H 
 H        H     H  M  H 
EHQwWwWwWwWwWwWeHqWwWeHq
 H              H     H 
 H     H        H     H 
 H     H        H     H 
EHQwWwEHQwWwWwWeHqWwWeHq
 H     H        H     H 
 H     H        H     H 
 H     H    P   H     H 